###############################################################################################################################################
###############################################################################################################################################
###############################################################################################################################################
###############################################################################################################################################
###############################################################################################################################################
###############################################################################################################################################
###############################################################################################################################################
###############################################################################################################################################
###############################################################################################################################################
###############################################################################################################################################
###############################################################################################################################################
###############################################################################################################################################
###############################################################################################################################################
#####################################################             #############################################################################
###################################################                 ###########################################################################
#################################################                     #########################################################################
#################################################                     #########################################################################
#################################################                     #########################################################################
###################################################                 ###########################################################################
#####################################################             ################################################# ###########################
####################################################                ############################################### ###########################
###################################################                  ############################################### ##########################
#######################################################                     #########################################   #######################
#######################################################                          ##################        ##########   #######################
#####################################################                    ###             ########     ####    #######   #######################
######################################################      ##             ###########               #######    ###    ########################
######################################################     ####      ##       ################################       ##########################
########################################################     ####      ####       ###############        ######################################
#######################################################     ########     #######        ####       ###     ####################################
######################################################################       #######          ###########     ###########    ##################
########################################################################      ##############################     #####    ##  #################
#########################################################################    ##################################         ###### ################
########################################################################     ################################################# ################
##########################################################################    ###########          ##    ######################################
############################################################################    #####      #####      ##  #####################################
#############################################################################            #####   ##   ####  ###################################
###############################################################################################     ######## ##################################
############################################################################################################ ##################################
###############################################################################################################################################
###############################################################################################################################################
###############################################################################################################################################
###############################################################################################################################################
###############################################################################################################################################
###############################################################################################################################################
