###############################################################################################################################################
###############################################################################################################################################
###############################################################################################################################################
###############################################################################################################################################
###############################################################################################################################################
###############################################################################################################################################
###############################################################################################################################################
###############################################################################################################################################
###############################################################################################################################################
###############################################################################################################################################
###############################################################################################################################################
########################### #################################################################################      ############################
############################ #############################################################################   #####   ##########################
############################  #######################             ######################################   #########   ########################
#############################   ###################                 ###################################   #     ####  #########################
##############################    ################  ##### ## #####   ###############################         ##   ## ##########################
######################      ###    ##############   # # #    # # #    ##########################      ###   ###   ## ##########################
####################   ###        ###############         z           ######################        ######       ##############################
####################   ##      ####################      ####       ####################         ##############################################
#####################     ##    #####################             ####################       ###################### ###########################
#############################    ###################                ###############        ######################## ###########################
############################      #################                  ##########         ############################ ##########################
############################        #########                                       #################################   #######################
##############################                                                   ##################        ##########   #######################
#########################################                                ###             ########     ####    #######   #######################
######################################                      ##             ###########               #######    ###    ########################
##################################       #####      ##     ####      ##       ################################       ##########################
################################      #######      #####     ####      ####       ###############        ######################################
###########################        ##########    #####     ########     #######        ####       ###     #####################################
#########################   ####    #########    #######     #########       #######          ###########     ###########    ##################
#########################   ###    ###########    #######     ##########      ##############################     #####    ##  #################
##########################      ##############    #######     ##########    ##################################         ###### #################
#############################    ############   ############     #######     ################################################# ################
###########################     ############        ##########     #######    ###########          ##    ######################################
##########################     ###########      ##    ##########     #######    #####      #####      ##  #####################################
########################     ############   ##      ###############     #####            #####   ##   ####  ###################################
####################       ##############    #######################    #######################     ######## ##################################
#################     ###################   #####################     ##################################### ###################################
###############    ########################    #################    ###########################################################################
#############   #############################   #################  ############################################################################
#############p ################################  ################# ############################################################################
################################################    ###########################################################################################
################################################### ###########################################################################################
###############################################################################################################################################
