###############################################################################################################################################
###############################################################################################################################################
###############################################################################################################################################
###############################################################################################################################################
###############################################################################################################################################
###############################################################################################################################################
###############################################################################################################################################
###############################################################################################################################################
###############################################################################################################################################
###############################################################################################################################################
###############################################################################################################################################
###############################################################################################################################################
###############################################################################################################################################
#####################################################             #############################################################################
###################################################                 ###########################################################################
#################################################                     #########################################################################
#################################################                     #########################################################################
#################################################                     #########################################################################
###################################################                 ###########################################################################
#####################################################             ################################################# ###########################
####################################################                ############################################### ###########################
###################################################                  ############################################### ##########################
#######################################################                     #########################################   #######################
#######################################################                    ##################        ##########   #############################
############################################################             ###             ########     ####    #######   #######################
##############################################################             ###########               #######    ###    ########################
###############################################################      ##       ################################       ##########################
#################################################################      ####       ###############        ######################################
####################################################################     #######        ####       ###     ####################################
######################################################################       #######          ###########     ###########    ##################
########################################################################      ##############################     #####    ##  #################
#########################################################################    ##################################         ###### ################
########################################################################     ################################################# ################
##########################################################################    ###########          ##    #################################
############################################################################    #####      #####      ##  #####################################
#############################################################################            #####   ##   ####  ###################################
###############################################################################################     ######## ##################################
############################################################################################################ ##################################
###############################################################################################################################################
###############################################################################################################################################
###############################################################################################################################################
###############################################################################################################################################
###############################################################################################################################################
###############################################################################################################################################
