########################### #################################################################################      ###################################
############################ #############################################################################   #####   #################################
############################  #######################             ######################################   #########   ###############################
#############################   ###################                 ###################################   #     ####  ################################
##############################    ################  ##### ## #####   ###############################         ##   ## #################################
######################      ###    ##############   # # #    # # #    ##########################      ###   ###   ## #################################
####################   ###        ###############         z           ######################        ######       #####################################
####################   ##      ####################      ####       ####################         #####################################################
#####################     ##    #####################             ####################       ###################### ##################################
#############################    ###################                ###############        ######################## ##################################
############################      #################                  ##########         ############################ #################################
############################        #########                                       #################################   ##############################
##############################                                                   ##################        ##########   ##############################
#########################################                                ###             ########     ####    #######   ##############################
######################################                      ##             ###########               #######    ###    ###############################
##################################       #####      ##     ####      ##       ################################       #################################
################################      #######      #####     ####      ####       ###############        #############################################
###########################        ##########    #####     ########     #######        ####       ###     ############################################
#########################   ####    #########    #######     #########       #######          ###########     ###########    #########################
#########################   ###    ###########    #######     ##########      ##############################     #####    ##  ########################
##########################      ##############    #######     ##########    ##################################         ###### ########################
#############################    ############   ############     #######     ################################################# #######################
###########################     ############        ##########     #######    ###########          ##    #############################################
##########################     ###########      ##    ##########     #######    #####      #####      ##  ############################################
########################     ############   ##      ###############     #####            #####   ##   ####  ##########################################
####################       ##############    #######################    #######################     ######## #########################################
#################     ###################   #####################     ##################################### ##########################################
###############    ########################    #################    ##################################################################################
#############   #############################   #################  ###################################################################################
#############p ################################  ################# ###################################################################################
